DIABLOL	DIABLO
MIDWAY2L	MIDWAY2
ROUND_MT2L	ROUND_MT2
EAGLROCKL	EAGLROCK
LITEHIPEL	LITEHIPE
LUGOL	LUGO
MESA_CAL2L	MESA_CAL2
MIRALOMAL	MIRALOMA
MIRALOMA2L	MIRALOMA2
PARDEEL	PARDEE
VALLEYL	VALLEY
VINCENT2L	VINCENT2
MIGUEL2L	MIGUEL2
MISSION2L	MISSION2
S_ONOFRE2L	S_ONOFRE2
SERRANO2L	SERRANO2
GATES2L	GATES2
MORROBAYL	MORROBAY
PANOCHEL	PANOCHE
WILSONL	WILSON
GREGGL	GREGG
MC_CALLL	MC_CALL
TABLE_MTL	TABLE_MT
SUMMITL	SUMMIT
HUMBOLDTL	HUMBOLDT
FULTONL	FULTON
SOBRANTEL	SOBRANTE
C_COSTAL	C_COSTA
PITSBURG2L	PITSBURG2
MORAGAL	MORAGA
NEWARKL	NEWARK
METCALF2L	METCALF2
SANMATEOL	SANMATEO
RAVENSWDL	RAVENSWD
MONTAVISL	MONTAVIS
JEFFERSNL	JEFFERSN
MARTINL	MARTIN
MARTIN2L	MARTIN2
EMBRCDRDL	EMBRCDRD
POTREROL	POTRERO